xxxxxxxxxxxxxxxxxxxxx
x@-------M----------x
x-xxxx-xxxxx-xxx-x--x
x----x-----x---x-x--x
xxx-xxx-xxx-xxx-x--xx
x---x---x---x---x---x
x-x-xxx-xxx-xxx-xxx-x
x-x---x---x---x---x-x
x-xxx-xxx-xxx-xxx-x-x
x-----x---x---x---x-x
xxx-xxx-xxx-xxx-xxx-x
x---x---x---x---x---x
x-xxx-xxx-xxx-xxx-xxx
x------------E---M--x
xxxxxxxxxxxxxxxxxxxxx
