xxxxxxxxxxxxxxxxxxxx
x@------M----x-----x
x-xxxx-xxxxx-x-xxx-x
x-x----x---x-x-x-x-x
x-x-xxx-xxx-x-x-x--x
x-x---x---x---x-x-x
x-xxx-xxx-xxxxx-x-x
x-----x---x-----x-x
xxxxx-xxx-x-xxxxx-x
x---x---x---x-----x
x-x-xxx-xxxxx-xxx-x
x-x-------x-------x
x-xxx-xxx-xxx-xxx-x
x-----x---x---x---x
x-xxx-xxx-xxx-xxx-x
x-x---x-------x---x
x-x-xxx-xxxxx-xxx-x
x-x-----x---------x
x-xxxxx-xxxxxxxxxxx
x------M-------Exxx
xxxxxxxxxxxxxxxxxxx
